Map (17x15) - 152 tiles

?#???????#????? ?
#         #     #
? ?#???????#?#? ?
? #           # ?
? ? ?#?????#? ? ?
#   # #     # ? ?
? ?#? ?#?#? ? ? ?
#   #   #   # ? ?
? ? ? ?#?#? ? ? ?
? # /       # ? ?
? ? ?#? ???#? ? ?
? #           # ?
? ?#?????????#? ?
#               #
?#? ???????????#?
